CCCCCCCCCCCCCCCCCCCCCCCC
CBBBBBBBBCBBBBBBBBBBBBBC
CBBBBBBBBCBBBBBBBBBBBBBC
CAAAAAAAACAAAAAAAAAAAAAC
CAAAAAAAACAAAAAAAAAAAAAC
CAAAAAAAABAAAAAAAAAAAAAC
CAAAAAAAABAAAAAAAAAAAAAC
CCCCCCCAAAAAACCCCCCCCCCC
CBBBBBBAAAAAABBBBBBBBBBC
CBBBBBBAAAAAABBBBBBBBBBC
CAAAAAAAAAAAAAAAAAAAAAAC
CAAAAAAAAAAAAAAAAAAAAAAC
CAAAAAAAAAAAAAAAAAAAAAAC
CAAAAAAAAAAAAAAAAAAAAAAC
CCCCCCCCCCCCCCCCCCCCCCCC
BBBBBBBBBBBBBBBBBBBBBBBB
BBBBBBBBBBBBBBBBBBBBBBBB