CCCCCCCCCCCCCCCCCCCCCCCC
CBDFHBJBBCÑPPRSBUWYBBBBC
CBEGIBKBBCOQQBTBVXZBBBBC
CAAAAAALMCAAAAAAAAAAAAAC
CAAAAAAANCAAAAAAAAAAAAAC
CAAAAAAAABAAAAAAAAAAAAAC
CAAAAAAAABAAAAAAAAAAAAAC
CCCCCCCAAAAAACCCCCCCCCCC
CBB12BBAAAAAABBBBBBBBBBC
CBBBBBBAAAAAABBB0?BB¿@!C
CA357AAAAAAAAAAAAAAAAAAC
CA468AAAAAAAAAAAAALAAAAC
CAA9AAAAAAAAAAAAAAAAAAAC
CAAAAAAAAAAAAAAAAAAAAAAC
CCCCCCCCCCCCCCCCCCCCCCCC
BBBBBBBBBBBBBBBBBBBBBBBB
BBBBBBBBBBBBBBBBBBBBBBBB